77777777777
71310000047
71110007007
77770007007
70000000407
70400000007
70000777777
70000788887
70700187487
74000188887
77777777777