11111111111
10000000001
10000001001
11110001001
10000000001
10000000001
10000111111
10000100001
10100000001
10000000001
11111111111